NO ./path_to_the_north_texture
SO ./path_to_the_south_texture
WE ./path_to_the_west_texture
EA ./path_to_the_east_texture

F 220,100,0
C 225,30,0

			11111111111
			11000000001
			10000000011
			11100001111
			11000111111
			100000000111
			111110000111
111111111111100000000001
110000000000000000000001
100001111100000000000001
100000000000000000000001
101110000000000000000001
100000000000111111100001
100000000000000000000001
100001111111000000000001
100000000000000111100001
100000000000000000000001
100000111111100000000001
100000000000000000000001
111111111111111111111111