

        NO ./img/biere.xpm
        SO ./img/salad.xpm





         WE ./img/oranges.xpm
EA ./img/chips.xpm

F 186,172,124
C 18,60,158


1 1
111111111111111111111111
11000000000000000000000111
1111D11111000000000011111
100000000000000000000011
1011100000000000000000001111
100000000011111110000111
10000000000000000000001
11111D11111100000000011111
10000000000000011111111111
100000000000000000000011111
1000001111111111D11100001
1000000000000000000000W11111
111111111111111111111111