



         NO ./path_to_the_north_texture
         SO ./path_to_the_south_texture





         WE ./path_to_the_west_texture
EA ./path_to_the_east_texture

F 220,100,0
C 225,30,0


111111111111111111111111111
1100000000000000000000011111
1000011111000000N00000011111
1000000000000000000000011111
1011100000000000000000011111
1000000000001111111000011111
100000000000000000000001
100001111111000000000001
100000000000000111100001
1000000000000000000000011111
100000111111100000000001
100000000000000000000001
1111111111111111111111111111