



         NO ./img/brick-wall-hd.xpm
         SO ./img/brick-wall-grey-hd.xpm





         WE ./img/brick-wall-red-hd.xpm
EA ./img/brick-wall-brown-hd.xpm

F 186,172,124
C 18,60,158


1 1
111111111111111111111111
11000000000000000000000111
1111011111000000000011111
10000000000000000000001
101110000000000000000001111
100000000011111110000111
10000000000000000000001
1000011111110000000000011111
10000000000000011110011
100000000000000000000011111
10000011111110000000N001
1000000000000000000000011111
111111111111111111111111