



         NO ./img/bluestone.xpm
         SO ./img/greystone.xpm





         WE ./img/purplestone.xpm
EA ./img/redbrick.xpm

F 220,100,0
C 225,30,0


1 1
111111111111111111111111
11000000000000000000000111
100001111100000000000011111
100000000000000000000001
101110000000000000000001111
10000000001111111000011
1000N0000000000000000001
1000011111110000000000011111
100000000000000111100001
1000000000000000000000011111
100000111111100000000001
1000000000000000000000011111
11111111111111111111111
